NO
SO
WE
EA
F 220,100,0
C 225,30,0
111111
100001
100N01
111111
