NO ./textures/pillar.xpm
SO ./textures/purplestone.xpm
WE ./textures/redbrick.xpm
EA ./textures/wood.xpm
F 220,100,0
C 225,30,0
1111111111
1000001001
1000000001
1000010001
1000000001
1000010001
1000100001
10E0001001
1000000001
1000000101
1111111111
